
R    10000    10000

NO           ./textures/NO.xpm

SO             ./textures/SO.xpm

EA               ./textures/EA.xpm

WE        ./textures/WE.xpm

S     ./textures/3.xpm

C   135,206,235

F           34,139,34

111111111
1W0000021
10000021
1000021            11111111
100021   111111111100000001111111
100211111100000000001111000000021
102222222200000000001   111100201
121111111100000000001   111002001
11       111111111111   110020001
                        112000001
                        111111111