R 2000 1000
S ./textures/S.xpm
NO ./textures/NO.xpm
SO ./textures/SO.xpm
WE ./textures/WE.xpm
EA ./textures/EA.xpm
F 20,50,100
C 25,3,2

111111111111
100120000001
100102000001
1001002010E1
100100020001
100000002001
111111111111
