R 10000000 20000000
NO ./textures/NO.xpm
S ./textures/6.xpm
SO ./textures/SO.xpm
WE ./textures/WE.xpm
EA ./textures/EA.xpm
F 20,50,100
C 25,3,2
11111111111
10020000001
10020000001
100200000W1
10020000001
10020000001
11111111111