R 1920 1080
NO ./textures/NO.cub
SO ./textures/SO.cub
WE ./textures/WE.cub
EA ./textures/EA.cub
S ./textures/S.cub
F 20,50,100
C 25,3,2

1111111111111111111111111111111111
1100000000000000000000000000001001
1111000000000000000000000000011001
1111110000000002011100000000011001
1111110000000000011100000000011001
1111110000000000000000000000E00001
1111110000000000000000000000000001
1111111111111111111111111111111111
11 11 11 11 11 11 11 11 11 11 11 1
