R 100 100
NO ./textures/NO .xpm
S ./textures/S.xpm
SO ./textures/SO.xpm
WE ./textures/WE.xpm
EA ./textures/EA.xpm
F 0,0,0
C 0,0,0

111111111111111111111
100000000000000000001
122222222212122200001
122222222212122200001
122222222212122200001
122222222212122200001
122222222211111200001
122222222211111200001
122222222211111200001
122222222212122200001
122222222212122201001
122222222212122200001
1222222222121222000W1
100000000000000000001
111111111111111111111