R 1900 1000
NO ./textures/NO_TXT.xpm
SO ./textures/SO_TXT.xpm
WE ./textures/WE_TXT.xpm
EA ./textures/EA_TXT.xpm
S ./textures/S_TXT.xpm
F 20,50,100
C 25,3,2

111111111111
100001000001
100000000001
100011000001
100000000001
10000N000001
111111111111
