R 100000 1000000
NO ./textures/NO.xpm
S ./textures/S.xpm
SO ./textures/SO.xpm
WE ./textures/WE.xpm
EA ./textures/EA.xpm
F 20,50,100
C 0,0,0

11111111111111111111
 1222222222222222N1
  122222222222221111
   12222222222211
    12222122221
    12222122221
    12222122221
   1222221222221
  122222222222221
 12222111111222221
122222222222222221
11111111111111111111