R 1000 1000
NO ./textures/NO.cub
SO ./textures/SO.cub
WE ./textures/WE.cub
EA ./textures/EA.cub
S ./textures/S.cub
F 20,50,100
C 25,3,2

1111111111111111111111111111111111
1100000000000000000000000000001111
1100000000000000000000000000001111
1100000000000002000000000000001111
1100000000000000000000000000001111
1100000000000000000000000000W01111
1111111111111111111111111111111111
