R 100000 1000000
NO ./textures/wall42_1.xpm
S ./textures/S.xpm
SO ./textures/wall42_2.xpm
WE ./textures/wall42_3.xpm
EA ./textures/wall42_4.xpm
F 20,50,100
C 0,0,0

11111 111111 11111111
111111111111111111111
11222222222222222N1
11111111111111111111
1111111111111111111111
111111111111111111111111
1111112222122221
    122221222211
    12222122201
   1222221222221
  122222222222221
 12222111111222221
1111111111 11111111111