R 2000 1000
NO ./textures/NO.xpm
S ./textures/6.xpm
SO ./textures/SO.xpm
WE ./textures/WE.xpm
EA ./textures/EA.xpm
F 20,50,100
C 25,3,2

1111111111111111
1002000N001
1000020000011111
100000201001
100000020001
10000000200011
 10000002001
 11111001111111
11111001111111
10000000002001
100000000002001
100000000000001
111111111111111
