R 0100 0100
NO ./textures/NO.xpm
S ./textures/6.xpm
SO ./textures/SO.xpm
WE ./textures/WE.xpm
EA ./textures/EA.xpm
F 20,50,100
C 25,3,2
1111111111111111
1002000N001
11111111111