R 500 500
NO ./textures/64.xpm
SO ./textures/2048.xpm
EA ./textures/3.xpm
WE ./textures/WE.xpm
S ./textures/6.xpm
C 255,255,255
F 0,0,0

111111111
100000021
10000021
1000021
100021
10N21
1021
121
11