R 2000 1000
NO ./textures/NO.xpm
S ./textures/S.xpm
SO ./textures/SO.xpm
WE ./textures/WE.xpm
EA ./textures/EA.xpm
F 20,50,100
C 25,3,2

11111111111
1002000N001
100002000001
100000201001
100000020001
1000000020001
1000000002001
10000000002001
100000000002001
100000000000001
111111111111111
