R 1920 1080
NO ./textures/NO.cub
SO ./textures/SO.cub
WE ./textures/WE.cub
EA ./textures/EA.cub
S ./textures/S.cub
F 20,50,100
C 25,3,2

1111111111111111111
1000000000000000001
1000000000100011001
1000000011100000001
1000000010000000001
1001100000N00011001
1000000000000000001
1111111111111111111
