R 1920 1080
NO ./textures/NO.cub
SO ./textures/SO.cub
WE ./textures/WE.cub
EA ./textures/EA.cub
S ./textures/S.cub
F 20,50,100
C 25,3,2

111111111111
10001N000001
100001000001
100000000001
100000000001
100000000001
111111111111
