R 1920 1080
NO ./textures/NO.cub
SO ./textures/SO.cub
WE ./textures/WE.cub
EA ./textures/EA.cub
S ./textures/S.cub
F 20,50,100
C 25,3,2

11111111111111111111111111111111111111
11000000000000000000000000000000000001
11110000000000000000000000000000000001
11111100000000000000000000000000000001
11111100000000001000000000000000000001
11111100000000001000000000000000000001
11111100000000000000000111000000000001
11111100000000000000000011000000000001
11111100000000000000000000000000000001
11111100000000011000000000000000000001
11111100000000000000001000000000000001
11111100000000000N00000000000000000001
11111111111111111111111111111111111111
11 11 11 11 11 11 11 11 11 11 11 1111
