R 2000 1000
NO ./textures/NO.xpm
SO ./textures/SO.xpm
WE ./textures/WE.xpm
EA ./textures/EA.xpm
S ./textures/S.xpm
F 20,50,100
C 25,3,2

111111111111
100001000001
100000000001
100011000001
100000000001
10000E000001
111111111111
