R 1000 1000
NO ./textures/NO.cub
SO ./textures/SO.cub
WE ./textures/WE.cub
EA ./textures/EA.cub
S ./textures/S.cub
F 20,50,100
C 25,3,2

1111111111111111111111111111111111
        10000000000110000000000001
        1011001001110000002000111
        1001000000000000000100001
1111111110110000001100000000W0111
111111111111111111111111111111111