R 1000 500
NO ./textures/NO.xpm
S ./textures/S.xpm
SO ./textures/SO.xpm
WE ./textures/WE.xpm
EA ./textures/EA.xpm
F 20,50,100
C 0,0,0
111111111111111111
100000000000000001
100000001000200001
100000100020000E01
100010002000000001
101000020000000001
100000000000000001
111111111111111111